Culpability =  state of guilt or responsibility
Toddler = child between the ages of one and three
Hilt = the handle of a weapon or tool, especially a sword, dagger, or knife.
Cosplay = Dressing up and pretending to be a fictional character 
Lethargy = a lack of energy and enthusiasm.
Hoax = A hoax is a deliberately fabricated falsehood made to masquerade as truth
Apathy = lack of interest, enthusiasm, or concern.
Empathy = capacity to share or recognize emotions experienced by another sentient or fictional being
Scant = barely sufficient or adequate.
Berserk = Destructively or frenetically violent
Frenetic = fast and energetic in a rather wild and uncontrolled way.
Rendition = a performance or interpretation, especially of a dramatic role or piece of music. 	
Disdain = lack of respect accompanied by a feeling of intense dislike
Chauffer(shou-fer) = person employed to drive a passenger motor vehicle, especially a luxury vehicle
Lament = a passionate expression of grief or sorrow.
Furor = a general outburst of enthusiasm, excitement, controversy, or the like.
Sober = not affected by alcohol; not drunk.
Adversary = someone who offers opposition
Multitude = a large number of people or things.
Fortitude = courage in pain or adversity
Meticulous = showing great attention to detail; very careful and precise.
Sporadic = occurring at irregular intervals or only in a few places
Polemic = a strong verbal or written attack on someone or something.
Concoction = a mixture of various ingredients or elements.
Pandemic = epidemic over a large area.
Cushy = undemanding, easy, or secure.
Sinecure = a position requiring little or no work but giving the holder status or financial benefit.
Denouement [dey-noo-mahn] = the final resolution of the intricacies of a plot, as of a drama or novel. 
Intricate = having many interrelated parts or facets
Facet = one side of something many sided
Deity[de-aty] = divine status, quality, or nature.
Trephine = surgical instrument with a cylindrical saw usually used for removing a disk of bone, especially from the skull
Reveller = a person who is enjoying themselves in a lively and noisy way.
Frisk = to search (a person) for concealed weapons, contraband goods, etc., by feeling the person's clothing
Frolic = play or move about in a cheerful and lively way.
Euphoric = characterized by or feeling intense excitement and happiness.
Incest = sexual activity between family members or close relatives.
Squat = crouch or sit with one's knees bent and one's heels close to or touching one's buttocks or the back of one's thighs
Novelty = the quality of being new, original, or unusual.
Exorbitant = (of a price or amount charged) unreasonably high.
Trippy = inducing the hallucinatory effect produced by taking a psychedelic drug.
Nudge = prod (someone) gently with one's elbow in order to attract attention.
Prod = poke with a finger, foot, or pointed object.
Furore = an outbreak of public anger or excitement.
Foible = a minor weakness or eccentricity in someone's character.
Leer = look or gaze in a lascivious or unpleasant way.
Lascivious = feeling or revealing an overt sexual interest or desire.
Overt = done or shown openly; plainly apparent.
Expendable = of relatively little significance, and therefore able to be abandoned or destroyed.
Retaliation = the action of returning a military attack; counter-attack.
Skirmish = an episode of irregular or unpremeditated fighting, especially between small or outlying parts of armies or fleets
Unpremeditated = (of an act, remark, or state) not thought out or planned beforehand.
Daze = a state of stunned confusion or bewilderment.
Frugal = sparing or economical as regards money or food.
Paunch = a large or protruding belly.
Flabby = (of a part of a person's body) soft, loose, and fleshy.
Mum = silent
Cavalier = showing a lack of proper concern; offhand.
Offhand = ungraciously or offensively nonchalant or cool in manner.
Nonchalant = appearing casually calm and relaxed; not displaying anxiety, interest, or enthusiasm
Ravenous = extremely hungry.
Ravishing = delightful; entrancing.
Entrance = fill (someone) with wonder and delight, holding their entire attention.
Antagonist = a person who actively opposes or is hostile to someone or something; an adversary.
Protagonist = the leading character or one of the major characters in a play, film, novel, etc.
Jingoism = extreme patriotism, especially in the form of aggressive or warlike foreign policy.
Unbeknown = without the knowledge of (someone).
Bleak = (of a building or room) charmless and inhospitable; dreary.
Dreary = depressingly dull and bleak or repetitive.
Vagary = an unexpected and inexplicable change in a situation or in someone's behaviour.
Inexplicable = unable to be explained or accounted for.
Smear = coat or mark (something) messily or carelessly with a greasy or sticky substance.
Faction = a small organized dissenting group within a larger one, especially in politics.
Dissent = hold or express opinions that are at variance with those commonly or officially held.
